8 8
#.#.#.#.
........
#.#.....
#.##.#..
..#..##.
#..##...
...#...#
#.s#d.#.
